12
16
################
***#*****#*****#
***#*****#*****#
#**#**#**#**#**#
#**#**#**#**#**#
#**#**#**#**#**#
#**#**#**#**#**#
#**#**#**#**#**#
#**#**#**#**#**#
#*****#*****#***
#*****#*****#***
################