12
16
################
#***************
#***************
#**************#
#**************#
#**************#
#**************#
#**************#
#**************#
***************#
***************#
################